Can	TASK
you	TASK
give	TASK
me	TASK
more	TASK
details	TASK
or	TASK
email	TASK
the	TASK
plan	TASK
prior	TASK
to	TASK
meeting	TASK
?	0
What	REQUEST
do	REQUEST
I	REQUEST
need	REQUEST
to	REQUEST
provide	REQUEST
besides	REQUEST
headcount	REQUEST
?	0
Otherwise	0
any	0
afternoon	0
next	0
week	0
would	0
be	0
fine	0
Phillip	0
